C 255,20 ,30
R  2147483647 2147483647
NO      ./textures/eagle.xpm
SO ./textures/greystone.xpm
EA ./textures/red.xpm
WE ./textures/purplestone.xpm

S ./textures/tonneau.xpm
F  000, 000, 00



111111111111111111111111111111
111111111000200000000000011111
100000000000000000111000100001
110000100000000000000000001111
100001111111000000020000111111
1111111000000000W0000000000001
111100000000001100000002000011
111111000011111111111111111111
110000000000011110000000000011
100000000000111000000000000011
11000000000011100000000000111100
110000000001111000000000000111
110111111111111111111111111111111
110111111111110020011111111111
110111111111111020011111111111
110000000000000000011111111111
111111111111111111111111111111
